1111111
1P00101
1000001
1E00C01
1111111
