1111111
1P001000
1000001
1E00C01
1111111
