111111
1P0000
100001
1E00C1
111111