111111
1P0001
100001
1E00C0
111111