1111111
1P00101
100T001
1E00C01
1111111
