1111111
1P00101
1000e01
1E00C01
1111111
