1111111
1P0C0E1
1000N01
111111