1111111111111111111
1P000E10000000000C1
1000000000000010001
1000000000000000001
100000000000000N001
1111111111111111111