11111111111111111111111
1C00000000000100C1110C1
10001111110000001101001
11011100000000000100011
1E000000001111000001111
111111110001C1000000011
1C001001000101111110001
1010000100010111C010001
11111101000000010010001
1C0000000000000000000P1
11111111111111111111111