11111111111111111111111
1C00000000000100C110001
10000000000000001101101
1101110000111100C100011
1E000000001111000011111
11111111000111000000001
1C000000000001000000001
10000000000001000000001
11011100001111000000001
10000000000C000000C00P1
11111111111111111111111
