111111111111111
100C000C000E001
1P0000000000001
111111111111111