1111111111111111111
1P0000E1000000000C1
1000000000000010001
1000000000000000001
1000000000000000N01
1111111111111111111