111111111111111
100C000C000E001
1P000000000000
111111111111111